00000000000000000000000000000000000000000000000000000000000
01111100111111111111111111100111111111110011111111111111110
01111100111111111111111111100111111111110011111111111111110
01111100111111111111111111100111111111110011111111111111110
01111111111111111111111111111111111111111111111111111111110
01111111111100000001111111111111111111111111111100000000000
01111111111111111111111111111111111111111111111100000000000
0111111111111111111111111111111111111111111111111111111111X
01111111111111111111111000000000011111111111111100000011000
01111100111111111111111111111111111111111111111100000011000
01111100111111111111111111111111111111111111111111111111110
01111100111111111111000000000011111111111111111111111111110
01111100111111111111111111111110000000000111111111111111110
00000000111111111111111111100111111111111111100000000000000
00000000111111111111111111100111111111111111100000000000000
01111111111111111111111111100111111111111111111111111111110
00000000000000000000000000000000000000000000000000000000000