1111111111111111111111111 
1010000011100000000000001
S000000011100000111000011
1000000001000000001100111
1000111000001000000000001
1100000000001000000000001
1001111000111110000001001
1000011110000000000111001
1000000000000000100001001
1000001111000001100001001                               
1000000001000000000111001
110000000000010000000000E
1110011100000100000000001
1100001100001110000000001
1111111111111111111111111